9,5,5,5,5,3,9,5,5,3
10,9,3,9,3,10,10,9,3,10
8,6,12,6,12,6,12,6,10,10
10,9,5,5,5,5,5,5,2,10
10,10,9,5,5,3,9,3,10,10
12,6,12,5,3,10,10,10,10,10
9,5,5,3,8,4,4,4,4,6
10,9,3,10,10,9,5,5,5,3
10,10,10,12,6,10,9,5,5,6
12,6,12,5,5,4,4,5,5,7